language-pack-af - translation updates for language Afrikaans
language-pack-am - translation updates for language Amharic
language-pack-an - translation updates for language Aragonese
language-pack-ar - translation updates for language Arabic
language-pack-as - translation updates for language Assamese
language-pack-ast - translation updates for language Asturian
language-pack-az - translation updates for language Azerbaijani
language-pack-be - translation updates for language Belarusian
language-pack-bg - translation updates for language Bulgarian
language-pack-bn - translation updates for language Bengali
language-pack-br - translation updates for language Breton
language-pack-bs - translation updates for language Bosnian
language-pack-ca - translation updates for language Catalan; Valencian
language-pack-crh - translation updates for language Tatar, Crimean
language-pack-cs - translation updates for language Czech
language-pack-cy - translation updates for language Welsh
language-pack-da - translation updates for language Danish
language-pack-de - translation updates for language German
language-pack-dz - translation updates for language Dzongkha
language-pack-el - translation updates for language Greek, Modern (1453-)
language-pack-en - translation updates for language English
language-pack-eo - translation updates for language Esperanto
language-pack-es - translation updates for language Spanish; Castilian
language-pack-et - translation updates for language Estonian
language-pack-eu - translation updates for language Basque
language-pack-fa - translation updates for language Persian
language-pack-fi - translation updates for language Finnish
language-pack-fr - translation updates for language French
language-pack-fur - translation updates for language Friulian
language-pack-ga - translation updates for language Irish
language-pack-gd - translation updates for language Gaelic; Scottish Gaelic
language-pack-gl - translation updates for language Galician
language-pack-gu - translation updates for language Gujarati
language-pack-he - translation updates for language Hebrew
language-pack-hi - translation updates for language Hindi
language-pack-hr - translation updates for language Croatian
language-pack-hu - translation updates for language Hungarian
language-pack-ia - translation updates for language Interlingua (International Auxiliary Language Association)
language-pack-id - translation updates for language Indonesian
language-pack-is - translation updates for language Icelandic
language-pack-it - translation updates for language Italian
language-pack-ja - translation updates for language Japanese
language-pack-ka - translation updates for language Georgian
language-pack-kk - translation updates for language Kazakh
language-pack-km - translation updates for language Central Khmer
language-pack-kn - translation updates for language Kannada
language-pack-ko - translation updates for language Korean
language-pack-ku - translation updates for language Kurdish
language-pack-lt - translation updates for language Lithuanian
language-pack-lv - translation updates for language Latvian
language-pack-mk - translation updates for language Macedonian
language-pack-ml - translation updates for language Malayalam
language-pack-mr - translation updates for language Marathi
language-pack-ms - translation updates for language Malay
language-pack-my - translation updates for language Burmese
language-pack-nb - translation updates for language Bokmål, Norwegian; Norwegian Bokmål
language-pack-nds - translation updates for language German, Low
language-pack-ne - translation updates for language Nepali
language-pack-nl - translation updates for language Dutch; Flemish
language-pack-nn - translation updates for language Norwegian Nynorsk; Nynorsk, Norwegian
language-pack-oc - translation updates for language Occitan (post 1500); Provençal
language-pack-or - translation updates for language Oriya
language-pack-pa - translation updates for language Panjabi; Punjabi
language-pack-pl - translation updates for language Polish
language-pack-pt - translation updates for language Portuguese
language-pack-ro - translation updates for language Romanian; Moldavian; Moldovan
language-pack-ru - translation updates for language Russian
language-pack-si - translation updates for language Sinhala; Sinhalese
language-pack-sk - translation updates for language Slovak
language-pack-sl - translation updates for language Slovenian
language-pack-sq - translation updates for language Albanian
language-pack-sr - translation updates for language Serbian
language-pack-sv - translation updates for language Swedish
language-pack-ta - translation updates for language Tamil
language-pack-te - translation updates for language Telugu
language-pack-tg - translation updates for language Tajik
language-pack-th - translation updates for language Thai
language-pack-tr - translation updates for language Turkish
language-pack-ug - translation updates for language Uighur; Uyghur
language-pack-uk - translation updates for language Ukrainian
language-pack-vi - translation updates for language Vietnamese
language-pack-xh - translation updates for language Xhosa
language-pack-zh-hans - translation updates for language Simplified Chinese
language-pack-zh-hant - translation updates for language Traditional Chinese
